Scheme: Idea

ResultList.GoToNextLocation	 "Go to Next Location": Global::Control+Alt+Down	Global::Control+Alt+Down	Global::Control+Alt+Down
ResultList.GoToPrevLocation	 "Go to Previous Location": Global::Control+Alt+Up	Global::Control+Alt+Up	Global::Control+Alt+Up
ShowLog	 "Show Log": Global::Shift+Control+Alt+L	Global::Shift+Control+Alt+L	Global::Shift+Control+Alt+L
TabLeft	 "": Global::Shift+Tab	Global::Shift+Tab	Global::Shift+Tab
ForceCompleteItem	 "Force completion of item": Global::Control+Return
GotoNextMethod	 "Next Member": Global::Alt+Down	Global::Alt+Down	Global::Alt+Down
GotoPrevMethod	 "Previous Member": Global::Alt+Up	Global::Alt+Up	Global::Alt+Up
WordNextExtend	 "Extend Selection to Next Word": Global::Shift+Control+Right
WordPrevExtend	 "Extend Selection to Prev Word": Global::Shift+Control+Left
WordDeleteToEnd	 "Delete text from the caret to the end of the word": Global::Control+Delete
ExtendSelection	 "E&xtend Selection": Global::Control+W
ShrinkSelection	 "S&hrink Selection": Global::Shift+Control+W	Global::Shift+Control+W
DuplicateText	 "&Duplicate Text": Global::Control+D
LineComment	 "Comment with Line Comment": Global::Control+Divide	Global::Control+Divide
BlockComment	 "Comment with Block Comment": Global::Shift+Control+Divide	Global::Shift+Control+Divide
CompleteCodeBasic	 "&Complete Symbol": Global::Control+Space	Global::Alt+Right	Global::Control+K W	Global::Control+K Control+W	Global::Control+Space	Global::Alt+Right
CompleteCodeTypeName	 "&Import Symbol": Global::Control+Alt+Space	Global::Control+Alt+Space
CompleteCodeSmart	 "&Smart Code Completion": Global::Shift+Control+Space	Global::Shift+Control+Space
ParameterInfo.Show	 "&Parameter Information": Global::Control+P	Global::Control+K P	Global::Control+K Control+P	Global::Shift+Control+Space
ParameterInfo.GoToPreviousSignature	 "": Global::Shift+Control+P	Global::Shift+Control+P	Global::Shift+Control+P
QuickDoc	 "Show &Quick Documentation…": Global::Control+Q
GotoType	 "Go to Everything / &Type…": Global::Control+N
GotoFile	 "Go to &File…": Global::Shift+Control+N	Global::Shift+Control+N	Global::Shift+Control+N
GotoSymbol	 "Go to &Symbol…": Global::Shift+Control+Alt+N	Global::Shift+Control+Alt+N	Global::Shift+Control+Alt+N
GotoFileMember	 "Go to File &Member…": Global::Control+F12	Global::Control+F12	Global::Control+F12
GotoUsage	 "Usages of Symbol": Global::Control+Alt+F7	Global::Control+Alt+F7	Global::Control+Alt+F7
GotoDeclaration	 "Go to Declaration": Global::Control+B
GotoImplementation	 "Go to Implementation": Global::Shift+Control+Alt+B	Global::Shift+Control+Alt+B	Global::Shift+Control+Alt+B
GotoBase	 "Base Symbols": Global::Control+U
GotoInheritors	 "Derived Symbols": Global::Control+Alt+B	Global::Control+Alt+B	Global::Control+Alt+B
GotoTypeDeclaration	 "Type of Symbol": Global::Shift+Control+T	Global::Shift+Control+T	Global::Shift+Control+T
GotoContainingDeclaration	 "Containing Declaration": Global::Control+OemOpenBrackets
NavigateTo	 "Navigate To…": Global::Shift+Control+G	Global::Shift+Control+G	Global::Shift+Control+G
GotoRelatedFiles	 "Related Files…": Global::Shift+Control+Alt+G	Global::Shift+Control+Alt+G	Global::Shift+Control+Alt+G
FindUsages	 "Find Usages": Global::Alt+F7	Global::Alt+F7	Global::Alt+F7
FindUsagesAdvanced	 "Find Usages Advanced…": Global::Shift+Alt+F7	Global::Shift+Alt+F7	Global::Shift+Alt+F7
HighlightUsages	 "Highlight Usages in File": Global::Shift+Control+F7	Global::Shift+Control+F7	Global::Shift+Control+F7
LocateInSolutionExplorer	 "Locate in Solution Explorer": Global::Shift+Alt+L	Global::Shift+Alt+L	Global::Shift+Alt+L
SelectContainingDeclaration	 "Select Containing Declaration": Global::Shift+Control+OemOpenBrackets
ShowFindResults	 "&Find Results": Global::Control+Alt+U	Global::Control+Alt+U	Global::Control+Alt+U
MoveUp	 "Move Up": Global::Shift+Control+Alt+Up	Global::Shift+Control+Alt+Up
MoveDown	 "Move Down": Global::Shift+Control+Alt+Down	Global::Shift+Control+Alt+Down
MoveLeft	 "Move Left": Global::Shift+Control+Alt+Left	Global::Shift+Control+Alt+Left
MoveRight	 "Move Right": Global::Shift+Control+Alt+Right	Global::Shift+Control+Alt+Right
Generate	 "Generate Code…": Global::Alt+Insert	Global::Alt+Insert	Global::Alt+Insert
CleanupCode	 "Cleanup Code…": Global::Control+Alt+F	Global::Control+Alt+F	Global::Control+Alt+F
GotoRecentFiles	 "&Recent Files…": Global::Control+E
GotoRecentEdits	 "Recent &Edits…": Global::Shift+Control+Alt+Back	Global::Shift+Control+Alt+Back	Global::Shift+Control+Alt+Back
GotoLastEditLocation	 "&Previous Edit": Global::Shift+Control+Back
AnalyzeReferences	 "Optimize References…": Global::Control+Alt+Y	Global::Control+Alt+Y	Global::Control+Alt+Y
TypeHierarchy.Browse	 "Hierarchies": Global::Control+Alt+H	Global::Control+Alt+H	Global::Control+Alt+H
ExploreStackTrace	 "&Browse Stack Trace…": Global::Shift+Control+E	Global::Shift+Control+E	Global::Shift+Control+E
Bookmarks.BookmarksMenu	 "Bookmarks…": Global::Control+Oemtilde	Global::Control+Oemtilde	Global::Control+Oemtilde
Bookmarks.ToggleBookmark0	 "Toggle Bookmark 0": Global::Shift+Control+D0	Global::Shift+Control+D0	Global::Shift+Control+D0
Bookmarks.ToggleBookmark1	 "Toggle Bookmark 1": Global::Shift+Control+D1	Global::Shift+Control+D1	Global::Shift+Control+D1
Bookmarks.ToggleBookmark2	 "Toggle Bookmark 2": Global::Shift+Control+D2	Global::Shift+Control+D2	Global::Shift+Control+D2
Bookmarks.ToggleBookmark3	 "Toggle Bookmark 3": Global::Shift+Control+D3	Global::Shift+Control+D3	Global::Shift+Control+D3
Bookmarks.ToggleBookmark4	 "Toggle Bookmark 4": Global::Shift+Control+D4	Global::Shift+Control+D4	Global::Shift+Control+D4
Bookmarks.ToggleBookmark5	 "Toggle Bookmark 5": Global::Shift+Control+D5	Global::Shift+Control+D5	Global::Shift+Control+D5
Bookmarks.ToggleBookmark6	 "Toggle Bookmark 6": Global::Shift+Control+D6	Global::Shift+Control+D6	Global::Shift+Control+D6
Bookmarks.ToggleBookmark7	 "Toggle Bookmark 7": Global::Shift+Control+D7	Global::Shift+Control+D7	Global::Shift+Control+D7
Bookmarks.ToggleBookmark8	 "Toggle Bookmark 8": Global::Shift+Control+D8	Global::Shift+Control+D8	Global::Shift+Control+D8
Bookmarks.ToggleBookmark9	 "Toggle Bookmark 9": Global::Shift+Control+D9	Global::Shift+Control+D9	Global::Shift+Control+D9
Bookmarks.GoToBookmark0	 "Go To Bookmark 0": Global::Control+D0	Global::Control+D0	Global::Control+D0
Bookmarks.GoToBookmark1	 "Go To Bookmark 1": Global::Control+D1	Global::Control+D1	Global::Control+D1
Bookmarks.GoToBookmark2	 "Go To Bookmark 2": Global::Control+D2	Global::Control+D2	Global::Control+D2
Bookmarks.GoToBookmark3	 "Go To Bookmark 3": Global::Control+D3	Global::Control+D3	Global::Control+D3
Bookmarks.GoToBookmark4	 "Go To Bookmark 4": Global::Control+D4	Global::Control+D4	Global::Control+D4
Bookmarks.GoToBookmark5	 "Go To Bookmark 5": Global::Control+D5	Global::Control+D5	Global::Control+D5
Bookmarks.GoToBookmark6	 "Go To Bookmark 6": Global::Control+D6	Global::Control+D6	Global::Control+D6
Bookmarks.GoToBookmark7	 "Go To Bookmark 7": Global::Control+D7	Global::Control+D7	Global::Control+D7
Bookmarks.GoToBookmark8	 "Go To Bookmark 8": Global::Control+D8	Global::Control+D8	Global::Control+D8
Bookmarks.GoToBookmark9	 "Go To Bookmark 9": Global::Control+D9	Global::Control+D9	Global::Control+D9
InspectThis	 "Inspect This…": Global::Shift+Control+Alt+A	Global::Shift+Control+Alt+A	Global::Shift+Control+Alt+A
ShowInspectionWindow	 "&Inspections": Global::Control+Alt+Oemcomma	Global::Control+Alt+Oemcomma	Global::Control+Alt+Oemcomma
ShowCodeStructure	 "File &Structure": Global::Control+F11	Global::Control+F11	Global::Control+F11
ShowTodoExplorer	 "To-do Items": Global::Control+Alt+OemPeriod	Global::Control+Alt+OemPeriod	Global::Control+Alt+OemPeriod
UnitTestSession.RepeatPreviousRun	 "R&epeat Previous Run": Global::Control+T Control+T	Global::Control+T Control+T	Global::Control+T T	Global::Control+T Control+T
ReSharper_UnitTest_RunContext	 "Run Unit Tests": Global::Control+T Control+R	Global::Control+T Control+R	Global::Control+T R	Global::Control+T Control+R
ReSharper_UnitTest_DebugContext	 "Debug Unit Tests": Global::Control+T Control+D	Global::Control+T Control+D	Global::Control+T D	Global::Control+T Control+D
UnitTestSession.AppendTests	 "Append Tests to Session": Global::Control+T Control+A	Global::Control+T Control+A	Global::Control+T A	Global::Control+T Control+A
UnitTestSession.NewSession	 "Create New Session": Global::Control+T Control+N	Global::Control+T Control+N	Global::Control+T N	Global::Control+T Control+N
UnitTest.RunSolution	 "Ru&n All Tests from Solution": Global::Control+T Control+L	Global::Control+T Control+L	Global::Control+T L	Global::Control+T Control+L
UnitTest.RunCurrentSession	 "Run &Current Session": Global::Control+T Control+Y	Global::Control+T Control+Y	Global::Control+T Y	Global::Control+T Control+Y
ShowUnitTestExplorer	 "&Unit Tests": Global::Control+Alt+T	Global::Control+Alt+T	Global::Control+Alt+T
ShowUnitTestSessions	 "Unit Test Sessi&ons": Global::Control+Alt+R	Global::Control+Alt+R	Global::Control+Alt+R
GotoNextHighlight	 "Next Issue in File": Global::F12	Global::F12	Global::F12
GotoPrevHighlight	 "Previous Issue in File": Global::Shift+F12	Global::Shift+F12	Global::Shift+F12
GotoNextErrorInSolution	 "Next Error in Solution": Global::Alt+F12	Global::Alt+F12	Global::Alt+F12
GotoPrevErrorInSolution	 "Previous Error in Solution": Global::Shift+Alt+F12	Global::Shift+Alt+F12	Global::Shift+Alt+F12
RefactorThis	 "Refactor This…": Global::Shift+Control+R	Global::Shift+Control+R	Global::Shift+Control+R
Rename	 "Rename…": Global::F2	Global::F2	Global::Shift+F6	Global::Shift+F6	Global::Shift+F6
SafeDelete	 "Safe Delete…": Global::Alt+Delete	Global::Alt+Delete	Global::Alt+Delete
Move	 "Move…": Global::F6	Global::F6	Global::F6
ChangeSignature	 "Change Signature…": Global::Control+F6	Global::Control+F6	Global::Control+F6
IntroduceVariable	 "Introduce Variable…": Global::Control+Alt+V	Global::Control+Alt+V
IntroduceField	 "Introduce Field…": Global::Control+Alt+D	Global::Control+Alt+D
IntroParameter	 "Introduce Parameter…": Global::Control+Alt+P	Global::Control+Alt+P
ExtractMethod	 "Extract Method…": Global::Control+Alt+M	Global::Control+Alt+M
InlineVariable	 "Inline…": Global::Control+Alt+N	Global::Control+Alt+N
GenerateFileBesides	 "Create New File...": Global::Control+Alt+Insert	Global::Control+Alt+Insert	Global::Control+Alt+Insert
SurroundWith	 "S&urround With Template…": Global::Control+Alt+J	Global::Control+Alt+J
PasteMultiple	 "Paste…": Global::Shift+Control+V	Global::Shift+Control+V
ProfileVisualStudio	 "&Profile Visual Studio": Global::Shift+Control+Alt+P	Global::Shift+Control+Alt+P	Global::Shift+Control+Alt+P
SilentCleanupCode	 "": Global::Shift+Control+Alt+F	Global::Shift+Control+Alt+F	Global::Shift+Control+Alt+F
AltEnter	 "": Global::Alt+Return	Global::Alt+Return
WindowManager.CloseRecentTool	 "": Global::Shift+Control+F4	Global::Shift+Control+F4	Global::Shift+Control+F4
WindowManager.ActivateRecentTool	 "": Global::Control+Alt+Back	Global::Control+Alt+Back	Global::Control+Alt+Back
EnableDaemon	 "": Global::Shift+Control+Alt+D8	Global::Shift+Control+Alt+D8	Global::Shift+Control+Alt+D8
